A : A
Act : Hành động
B : B
Boy : Con trai
C : C
E : E
Engineer : Ky su
F : F
Girl : Con gai
H : H
Heart : Trai tim
Hello : Xin chào
Hi : Xin chao
Love : Yeu
Ping : Bao hieu
Play : Choi
Professional : Chuyên nghiệp
Teacher : Co giao
Dance : Nhay
Input : Vao
Output : Ra
Music : Am nhac
My : Cua toi
Onion : Toi
New : Moi
Number : So
Application : Phan mem
Null : Rong
Hour : Gio
In : Vao
Out : Ra
Think : Nghi
